1111111111111111111111111111111111
1E1000000000000C00000C000000000001
1010010100100000101001000000010111
1010010011110010001001000000010101
1P0000001C100C00000000000000000001
1111111111111111111111111111111111