111111111111
10P000000001
100000100001
100C00100101
100000000101
100001111101
1000010E0001
111111111111